*****************************
*           *               *
**********  ** ***** ********
*                *          *
******************** ********
*    *     *                *
*    *     *   **************
*          *                *
************************* ***
*                           *
****X************************