*****************************
*           *               *
**********  ** ***** ********
*        *       *          *
*  ****  *********** ********
*  *  *    *                *
*  ***     *   **************
*      *   *                *
******** **************** ***
*                           *
****X************************